ECONOMIC_DATA	经济数据
CITIZEN_STATUS	1、居民情况(钱单位:1/100克朗)
CITIZEN_COUNT	居民人数
FAMILY_COUNT	家庭户数
SALARY_PER_FAMILY	每户居民收入
CITIZEN_TAX_PER_FAMILY	居民平均纳税
EXPENSE_PER_FAMILY	每户固定支出
AVERAGE_TRANPORT_FEE	平均公交费用
HIGH_SALARY_COUNT	收支优秀的户数
MEDIUM_SALARY_COUNT	收支尚可的户数
LOW_SALARY_COUNT	收支糟糕的户数
WEALTH_HIGH_COUNT	富裕家庭
WEALTH_MEDIUM_COUNT	中产家庭
WEALTH_LOW_COUNT	贫穷家庭
BUILDING_STATUS	2、建筑情况
PROFIT_BUIDLING_COUNT	赚钱的公司数目
EXTERNAL_INVESTMENTS	可用于投资办公的钱
TIP1	提示1
TIP2	提示2
TIP3	提示3
TIP4	提示4
TIP5	提示5
TIP6	提示6
POLICY_COST	3、Mod新增政策费(钱单位: 克朗)
LIVING_ALLOWANCE	最低生活保障和福利
USE_TMPE_TIP	最好用TMPE并且禁止车辆消失
STARTUP_TIP	作为起步的城市,工业化是唯一的致富途径
TOURIST_TIP	旅游商业会帮你留住更多游客,游客会带来大量访问收入
OFFICE_TIP	办公会帮你得到外部投资,外部投资靠工商业利润得到
UNLOCK_TIP	不要上来就解锁全部,发展城市请参考真实世界
UG_TIP	更多细节请阅读工坊页面的UG
CITY_SALARY_TAX_INCOME_TITLE	1、城市居民所得税收入
SALARY_TAX_INCOME	居民所得税收入
TOURIST_INCOME_TITLE	2、城市旅游收入
FROM_RESIDENT	来自本地游客
FROM_TOURIST	来自外地游客
LAND_TAX_INCOME_TITLE	3、城市地税收入
RESIDENT_HIGH_LAND_INCOME	高密度居民区地税收入
RESIDENT_LOW_LAND_INCOME	低密度居民区地税收入
RESIDENT_HIGH_ECO_LAND_INCOME	高密度生态居民区地税收入
RESIDENT_LOW_ECO_LAND_INCOME	低密度生态居民区地税收入
COMMERICAL_HIGH_LAND_INCOME	高密度商业地税收入
COMMERICAL_LOW_LAND_INCOME	低密度商业地税收入
COMMERICAL_ECO_LAND_INCOME	生态商业地税收入
COMMERICAL_TOURISM_LAND_INCOME	旅游商业地税收入
COMMERICAL_LEISURE_LAND_INCOME	娱乐商业地税收入
INDUSTRIAL_GENERAL_LAND_INCOME	一般工业地税收入
INDUSTRIAL_FARMING_LAND_INCOME	农业地税收入
INDUSTRIAL_FORESTY_LAND_INCOME	林业地税收入
INDUSTRIAL_OIL_LAND_INCOME	石油业地税收入
INDUSTRIAL_ORE_LAND_INCOME	矿业地税收入
OFFICE_GENERAL_LAND_INCOME	一般办公区地税收入
OFFICE_HIGH_TECH_LAND_INCOME	高科技办公区地税收入
CITY_TRADE_INCOME_TITLE	4、城市交易税收入
COMMERICAL_HIGH_TRADE_INCOME	高密度商业交易税收入
COMMERICAL_LOW_TRADE_INCOME	低密度商业交易税收入
COMMERICAL_ECO_TRADE_INCOME	娱乐商业交易税收入
COMMERICAL_TOURISM_TRADE_INCOME	旅游商业交易税收入
COMMERICAL_LEISURE_TRADE_INCOME	生态商业交易税收入
INDUSTRIAL_GENERAL_TRADE_INCOME	一般工业交易税收入
INDUSTRIAL_FARMING_TRADE_INCOME	农业交易税收入
INDUSTRIAL_FORESTY_TRADE_INCOME	林业交易税收入
INDUSTRIAL_OIL_TRADE_INCOME	石油业交易税收入
INDUSTRIAL_ORE_TRADE_INCOME	矿业交易税收入
CITY_PUBLIC_TRANSPORT_INCOME_TITLE	5、城市公共交通收入
BUS	公交车
TRAM	有轨电车
TRAIN	火车
SHIP	渡船
PLANE	飞机
METRO	地铁
TAXI	出租车
CABLECAR	缆车
MONORAIL	单轨
CITY_PLAYER_BUILDING_INCOME_TITLE	6、政府建筑收入
ROAD	道路(包括加油站)
GARBAGE	垃圾
SCHOOL	学校
HEALTHCARE	医疗和殡葬
FIRESTATION	消防局
POLICESTATION	警察局
PLAYERINDUSTRY	国营工业
CITY_TOTAL_INCOME_TITLE	7、城市总收入
CITY_INCOME_DATA	城市收入情况(单位:克朗)
PARLIAMENT_HALL	议会大厅
PARLIAMENT_SEATS	议会席位
COMMUNIST	和谐党(你懂的)
GREEN	绿党
SOCIALIST	社会党
LIBERAL	自由党
NATIONAL	国家党
GOVERMENT	执政情况
LEFT_UNION	(左派联合)
WIDE_LEFT_UNION	(左派大联合)
RIGHT_UNION	(右翼联盟)
ALL_UNION	(全民团结政府)
NEXT_VOTE	下次选举时间
CURRENT_MEETING_ITEM	目前审理的议题
RISE_RESIDENT_TAX	升高居民税
FALL_RESIDENT_TAX	降低居民税
RISE_BENEFIT	增加福利
FALL_BENEFIT	降低福利
RISE_COMMERIAL_TAX	增加商业税
FALL_COMMERIAL_TAX	降低商业税
RISE_INDUSTRIAL_TAX	增加工业税
FALL_INDUSTRIAL_TAX	降低工业税
VOTE_RESULT	投票结果
YES	赞成
NO	反对
NO_ATTEND	弃权
CURRENT_POLICY	目前政策
BENEFIT	福利值
RESIDENT_SALARY_TAX	居民个人所得税
COMMERICAL_TRADE_TAX	商业交易税
INDUSTRIAL_TRADE_TAX	工业交易税
BUILDING_MONEY	公司现金流(单位:1/100克朗)
MATERIAL_BUFFER	原料仓库储存量
PRODUCTION_BUFFER	产品仓库储存量
AVERAGE_EMPLOYFEE	员工平均工资(按居民刷新周期算)
BUILDING_LANDRENT	土地费支出
PROFIT_SHARING	分红制(当次)
BUY_PRICE	原料买入平均价格
SELL_PRICE	产品卖出平均价格
MATERIAL_DIV_PRODUCTION	原料产品消耗比
SELL_TAX	卖出收入交易税
PROFIT	买入卖出利润率
EXCLUDE_VISIT_INCOME	(不包括商业访问收入)
FOOD	食物
COAL	矿物
LUMBER	木材
PETROL	汽油
GRAIN_MEAT	谷物或肉
ORE	原矿石
LOG	原木
OIL	原油
PREGOODS	库存商品
GOODS	货架商品
PRICE	价格
ANIMALPRODUCTS	动物制品
FLOURS	面粉
PAPER	纸
PLANEDTIMBER	木板木材
PETROLEUM	石油制品
PLASTICS	塑料
GLASS	玻璃
METALS	金属
LUXURY_PRODUCTS	奢侈消费品
FAMILY_MONEY	居民家庭存款(单位:1/100克朗)
FAMILY_SALARY	居民家庭总工资
FAMILY_GOODS	家里货物量
FAMILY_NEED_GOODS	(家里需要购物)
FAMILY_STATUS	家庭状况
INCLUDE_RESOURCE_TAX	(含60%资源税)
CAR_USED	使用中的车辆
MAINTAIN_FEE_TIPS	UI显示的维护费没包括车辆使用费用
LOCAL_WORKERS_DIV_TOTAL_WORKERS	本地工人/全体工人
TOURIST_MONEY	游客预算
SHOW_LACK_OF_RESOURCE	对卖空的商店显示缺货图标
DEBUG_MODE	更多的信息
REDUCE_CARGO_DESCRIPTION	减少卡车(工业DLC和非工业DLC建筑都有效果)
REDUCE_CARGO_ENABLE	启用减少卡车功能
INCOMPATIBILITY_CHECK_TIP	RealCity(系列)发现了一些不兼容的模组
REMOVE_STUCK_DESCRIPTION	自动移除卡住的人和车(会轻微影响游戏速度)
REMOVE_STUCK_ENABLE	启用自动移除卡住的人和车
BASIC_SETTING	基础设置
SPTB	智能公共交通
SMART_PUBLIC_TRANSPORT_BUDGET_WEEKDAY	智能公共交通预算(工作日)
SMART_PUBLIC_TRANSPORT_BUDGET_WEEKEND	智能公共交通预算(周末)
WEEKDAY_MORNING_BUDGET	工作日早高峰预算(8-10)
WEEKDAY_EVENING_BUDGET	工作日晚高峰预算(17-19)
WEEKDAY_DEEPNIGHT_BUDGET	工作日深夜预算(0-4)
WEEKDAY_OTHER_BUDGET	工作日其它时间预算
WEEKEND_MORNING_BUDGET	周末早高峰预算(8-10)
WEEKEND_EVENING_BUDGET	周末晚高峰预算(17-19)
WEEKEND_DEEPNIGHT_BUDGET	周末深夜预算(0-4)
WEEKEND_OTHER_BUDGET	周末其它时间预算
WeekDayPlan	工作日预算
WeekEndPlan	周末预算
NoPlan	无预算
TLMRUNNING	TransportLineManager正在工作或RealTime没在工作,智能公共交通预算不会工作
TLMNOTRUNNING	TransportLineManager关闭,智能公共交通预算可以工作
MAX_MORNING_BUDGET	最大发车早高峰预算(8-10)
MAX_EVENING_BUDGET	最大发车晚高峰预算(17-19)
MAX_DEEPNIGHT_BUDGET	最大发车深夜预算(0-4)
MAX_OTHER_BUDGET	最大发车其余时间预算
MIN_MORNING_BUDGET	最小发车早高峰预算(8-10)
MIN_EVENING_BUDGET	最小发车晚高峰预算(17-19)
MIN_DEEPNIGHT_BUDGET	最小发车深夜预算(0-4)
MIN_OTHER_BUDGET	最小发车其它时间预算
MaxPlan	最大发车预算
MinPlan	最小发车预算
SPTB2	智能公共交通2
SMART_PUBLIC_TRANSPORT_BUDGET_MIN	智能公共交通预算(最小发车)
SMART_PUBLIC_TRANSPORT_BUDGET_MAX	智能公共交通预算(最大发车)
UNFINISHED_DEAL_LOST	未完成的交易退税
RESET_VALUE	清除关键数据